#################
#  --   X   -   #
#  H ---##  #   #
#  --    -  #---#
#   -   O       #
#   --   -      #
# X --    --    #
#  -       X -  #
#################