#################
#  --   X   -   #
#  H ---##  #   #
#  --    -  #---#
#   -   O       #
#   --   H      #
# X -H    --    #
#  -       X - H#
#################